Trait	First_Author	Label
20002_1065_PanUKBB_PanUKBBR1_1	PanUKBB	hypertension (Trans-ethnic (AFR,AMR,CSA,EAS,EUR... / UKBB
20002_1111_PanUKBB_PanUKBBR1_1	PanUKBB	asthma (Trans-ethnic (AFR,AMR,CSA,EAS,EUR,MID)) / UKBB
20002_1112_PanUKBB_PanUKBBR1_1	PanUKBB	chronic obstructive airways disease/copd (Europ... / UKBB
20002_1113_PanUKBB_PanUKBBR1_1	PanUKBB	emphysema/chronic bronchitis (Trans-ethnic (CSA... / UKBB
20002_1220_PanUKBB_PanUKBBR1_1	PanUKBB	diabetes (Trans-ethnic (AFR,CSA,EAS,EUR,MID)) / UKBB
20002_1222_PanUKBB_PanUKBBR1_1	PanUKBB	type 1 diabetes (European (EUR)) / UKBB
20002_1225_PanUKBB_PanUKBBR1_1	PanUKBB	hyperthyroidism/thyrotoxicosis (Trans-ethnic (A... / UKBB
20002_1226_PanUKBB_PanUKBBR1_1	PanUKBB	hypothyroidism/myxoedema (Trans-ethnic (AFR,CSA... / UKBB
20002_1234_PanUKBB_PanUKBBR1_1	PanUKBB	adrenocortical insufficiency/addison's disease ... / UKBB
20002_1261_PanUKBB_PanUKBBR1_1	PanUKBB	multiple sclerosis (European (EUR)) / UKBB
20002_1331_PanUKBB_PanUKBBR1_1	PanUKBB	pernicious anaemia (Trans-ethnic (CSA,EUR)) / UKBB
20002_1371_PanUKBB_PanUKBBR1_1	PanUKBB	sarcoidosis (European (EUR)) / UKBB
20002_1374_PanUKBB_PanUKBBR1_1	PanUKBB	allergy/hypersensitivity/anaphylaxis (European ... / UKBB
20002_1381_PanUKBB_PanUKBBR1_1	PanUKBB	systemic lupus erythematosis/sle (European (EUR)) / UKBB
20002_1387_PanUKBB_PanUKBBR1_1	PanUKBB	hayfever/allergic rhinitis (Trans-ethnic (AFR,A... / UKBB
20002_1417_PanUKBB_PanUKBBR1_1	PanUKBB	nasal polyps (European (EUR)) / UKBB
20002_1452_PanUKBB_PanUKBBR1_1	PanUKBB	eczema/dermatitis (Trans-ethnic (AFR,CSA,EAS,EUR)) / UKBB
20002_1456_PanUKBB_PanUKBBR1_1	PanUKBB	malabsorption/coeliac disease (European (EUR)) / UKBB
20002_1459_PanUKBB_PanUKBBR1_1	PanUKBB	colitis/not crohns or ulcerative colitis (Europ... / UKBB
20002_1462_PanUKBB_PanUKBBR1_1	PanUKBB	crohns disease (European (EUR)) / UKBB
20002_1463_PanUKBB_PanUKBBR1_1	PanUKBB	ulcerative colitis (Trans-ethnic (CSA,EUR)) / UKBB
20002_1464_PanUKBB_PanUKBBR1_1	PanUKBB	rheumatoid arthritis (Trans-ethnic (AFR,CSA,EUR)) / UKBB
20002_1561_PanUKBB_PanUKBBR1_1	PanUKBB	raynaud's phenomenon/disease (European (EUR)) / UKBB
20002_1661_PanUKBB_PanUKBBR1_1	PanUKBB	vitiligo (European (EUR)) / UKBB
AAD_Eriksson_33574239_1	Eriksson	Autoimmune Addison's disease (European (Finnish... / Eriksson
AAVMPO_Wong_up_1	Wong	MPO+ AAV (?) / Wong
AAVPR3_Wong_up_1	Wong	PR3+ AAV (?) / Wong
ALLERG_ASTHMA_EXMORE_FinnGen_FinnGenR5_1	FinnGen	Allergic asthma (mode) (more controls excluded) / FinnGen
ALLERG_ASTHMA_FinnGen_FinnGenR5_1	FinnGen	Allergic asthma / FinnGen
ALLERG_RHINITIS_FinnGen_FinnGenR5_1	FinnGen	Allergic rhinitis / FinnGen
APPENDACUT_NOCOMPLIC_FinnGen_FinnGenR5_1	FinnGen	Acute appendicitis, no complications / FinnGen
APPENDICITIS_BROAD_FinnGen_FinnGenR5_1	FinnGen	Appendicitis, broad definition / FinnGen
ASTAO_Ferreira_30929738_1	Ferreira	Adult-onset Asthma (European) / Ferreira
ASTCO_Ferreira_30929738_1	Ferreira	Childhood-onset Asthma (European) / Ferreira
ASTER_Ferreira_29083406_1	Ferreira	Asthma and/or Eczema and/or Rhinitis (European) / Ferreira
ASTE_Ferreira_29083406_1	Ferreira	Asthma-only vs. Eczema-only (European) / Ferreira
ASTHMA_ACUTE_RESPIRATORY_INFECTIONS_FinnGen_FinnGenR5_1	FinnGen	Asthma-related acute respiratory infections / FinnGen
ASTHMA_ALLERG_EXMORE_FinnGen_FinnGenR5_1	FinnGen	Asthma and allergy (more controls excluded) / FinnGen
ASTHMA_ALLERG_FinnGen_FinnGenR5_1	FinnGen	Asthma and allergy / FinnGen
ASTHMA_CHILD_EXMORE_FinnGen_FinnGenR5_1	FinnGen	Childhood asthma (age<16) (more controls excluded) / FinnGen
ASTHMA_CHILD_FinnGen_FinnGenR5_1	FinnGen	Childhood asthma (age<16) / FinnGen
ASTHMA_EOSINOPHIL_SUGG_FinnGen_FinnGenR5_1	FinnGen	Suggestive for eosinophilic asthma / FinnGen
ASTHMA_HOSPITAL_MAIN_FinnGen_FinnGenR5_1	FinnGen	Asthma, hospital admissions , main diagnosis only / FinnGen
ASTHMA_INFECTIONS_FinnGen_FinnGenR5_1	FinnGen	Asthma-related infections / FinnGen
ASTHMA_MIXED_EXMORE_FinnGen_FinnGenR5_1	FinnGen	Asthma mixed form (mode) (more controls excluded) / FinnGen
ASTHMA_MIXED_FinnGen_FinnGenR5_1	FinnGen	Asthma mixed form / FinnGen
ASTHMA_MODE_FinnGen_FinnGenR5_1	FinnGen	Asthma (mode) / FinnGen
ASTHMA_NAS_EXMORE_FinnGen_FinnGenR5_1	FinnGen	Asthma, unspecified (mode) (more controls exclu... / FinnGen
ASTHMA_NAS_FinnGen_FinnGenR5_1	FinnGen	Asthma (unspecified) / FinnGen
ASTHMA_NONALLERG_FinnGen_FinnGenR5_1	FinnGen	Non-allergic asthma (mode) / FinnGen
ASTHMA_NOS_EXMORE_FinnGen_FinnGenR5_1	FinnGen	Undetermined asthma (more controls excluded) / FinnGen
ASTHMA_OBESITY_FinnGen_FinnGenR5_1	FinnGen	Obesity related asthma / FinnGen
ASTHMA_PNEUMONIA_AND_SEPSIS_FinnGen_FinnGenR5_1	FinnGen	Asthma-related pneumonia or sepsis / FinnGen
ASTHMA_PNEUMONIA_FinnGen_FinnGenR5_1	FinnGen	Asthma-related pneumonia / FinnGen
AST_Demenais_29273806_2	Demenais	Asthma (Trans-ethnic (European + Asian + Africa... / Demenais
AST_Moffatt_20860503_1	Moffatt	Asthma (European) / Moffatt
AST_Myers_24824216_2	Myers	Asthma (European (North America)) / Myers
AST_Sakaue_doi1011012020102320213652_1	Sakaue	Asthma (East Asian (Japanese)) / Sakaue
ATD_Paternoster_26482879_1	Paternoster	Atopic Dermatitis (Trans-ethnic) / Paternoster
ATOPIC_STRICT_FinnGen_FinnGenR5_1	FinnGen	Atopic dermatitis, strict definition / FinnGen
ATOPIC_STRICT_REIMB_FinnGen_FinnGenR5_1	FinnGen	Atopic dermatitis, strict definition with reimb... / FinnGen
AUTOIMMUNE_FinnGen_FinnGenR5_1	FinnGen	Autoimmune diseases / FinnGen
AUTOIMMUNE_HYPERTHYROIDISM_FinnGen_FinnGenR5_1	FinnGen	Autoimmune hyperthyroidism / FinnGen
C3_OTHER_SKIN_EXALLC_FinnGen_FinnGenR5_1	FinnGen	Other malignant neoplasms of skin (ICD C excluded) / FinnGen
C3_OTHER_SKIN_FinnGen_FinnGenR5_1	FinnGen	Other malignant neoplasms of skin / FinnGen
C3_SKIN_EXALLC_FinnGen_FinnGenR5_1	FinnGen	Malignant neoplasm of skin (ICD C excluded) / FinnGen
C3_SKIN_FinnGen_FinnGenR5_1	FinnGen	Malignant neoplasm of skin / FinnGen
CD_Brant_27693347_1	Brant	Crohn's Disease (African (African Americans)) / Brant
CD_Liu_26192919_1	Liu	Crohn's Disease (European) / Liu
CHILDHOOD_ALLERGY_FinnGen_FinnGenR5_1	FinnGen	Childhood allergy (age < 16) / FinnGen
CHIRBIL_PRIM_FinnGen_FinnGenR5_1	FinnGen	Biliary chirrosis, primary / FinnGen
CHRONLARGE_FinnGen_FinnGenR5_1	FinnGen	Crohn's disease of large intestine / FinnGen
CHRONNAS_FinnGen_FinnGenR5_1	FinnGen	Chron's disease NAS / FinnGen
CHRONOTH_FinnGen_FinnGenR5_1	FinnGen	Other Chron's disease / FinnGen
CHRONSMALL_FinnGen_FinnGenR5_1	FinnGen	Crohn's disease of small interstine / FinnGen
COPD_ASTHMA_INFECTIONS_FinnGen_FinnGenR5_1	FinnGen	COPD/asthma related infections / FinnGen
COPD_HOSPITAL_FinnGen_FinnGenR5_1	FinnGen	COPD, hospital admissions / FinnGen
COPD_MODE_FinnGen_FinnGenR5_1	FinnGen	COPD (mode) / FinnGen
CREST_FinnGen_FinnGenR5_1	FinnGen	CR(E)ST syndrome / FinnGen
D3_ANAEMIA_B12_DEF_FinnGen_FinnGenR5_1	FinnGen	Vitamin B12 deficiency anaemia / FinnGen
D3_ANAEMIA_FinnGen_FinnGenR5_1	FinnGen	Anaemias / FinnGen
D3_BLOOD_FinnGen_FinnGenR5_1	FinnGen	Diseases of the blood and blood-forming organs ... / FinnGen
D3_IMMUNEMECHANISM_FinnGen_FinnGenR5_1	FinnGen	Certain disorders involving the immune mechanism / FinnGen
D3_NUTRIANAEMIA_FinnGen_FinnGenR5_1	FinnGen	Nutritional anaemias / FinnGen
D3_SARCOIDOSIS_FinnGen_FinnGenR5_1	FinnGen	Sarcoidosis / FinnGen
DIABETES_FG_FinnGen_FinnGenR5_1	FinnGen	Diabetes, varying definitions / FinnGen
DMY_Miller_26291516_1	Miller	Dermatomyositis (European) / Miller
DMY_Rothwell_up_1	Rothwell	Dermatomyositis (European) / Rothwell
DM_BCKGRND_RETINA_FinnGen_FinnGenR5_1	FinnGen	Background diabetic retinopathy / FinnGen
DM_BCKGRND_RETINA_NONPROLIF_FinnGen_FinnGenR5_1	FinnGen	Severe non-proliferative background diabetic re... / FinnGen
DM_COMORB_EXMORE_FinnGen_FinnGenR5_1	FinnGen	Diabetes-related co-morbidities/complications (... / FinnGen
DM_HYPOGLYC_FinnGen_FinnGenR5_1	FinnGen	Diabetic hypoglycemia / FinnGen
DM_KETOACIDOSIS_FinnGen_FinnGenR5_1	FinnGen	Diabetic ketoacidosis / FinnGen
DM_MACULOPATHY_EXMORE_FinnGen_FinnGenR5_1	FinnGen	Diabetic maculopathy (more controls excluded) / FinnGen
DM_MACULOPATHY_FinnGen_FinnGenR5_1	FinnGen	Diabetic maculopathy / FinnGen
DM_NEPHROPATHY_EXMORE_FinnGen_FinnGenR5_1	FinnGen	Diabetic nephropathy (more controls excluded) / FinnGen
DM_NEUROPATHY_FinnGen_FinnGenR5_1	FinnGen	Diabetic neuropathy / FinnGen
DM_OTHER_WIDE_FinnGen_FinnGenR5_1	FinnGen	Other diabetes, wide definition / FinnGen
DM_RETINA_NOS_FinnGen_FinnGenR5_1	FinnGen	Unspecified diabetic retinopathy / FinnGen
DM_RETINA_PROLIF_FinnGen_FinnGenR5_1	FinnGen	Proliferative diabetic retinopathy / FinnGen
DM_RETINOPATHY_EXMORE_FinnGen_FinnGenR5_1	FinnGen	Diabetic retinopathy (more controls excluded) / FinnGen
DM_RETINOPATHY_FinnGen_FinnGenR5_1	FinnGen	Diabetic retinopathy / FinnGen
DM_SEVERAL_COMPLICATIONS_FinnGen_FinnGenR5_1	FinnGen	Diabetes, several complications / FinnGen
DM_VITREOUS_BLEEDING_FinnGen_FinnGenR5_1	FinnGen	Vitreous bleeding (caused by prolif. dmrp when ... / FinnGen
E4_CONGEIOD_FinnGen_FinnGenR5_1	FinnGen	Congenital iodine-deficiency syndrome/hypothyro... / FinnGen
E4_DIABETES_FinnGen_FinnGenR5_1	FinnGen	Diabetes mellitus / FinnGen
E4_DM1COMA_FinnGen_FinnGenR5_1	FinnGen	Type 1 diabetes with coma / FinnGen
E4_DM1KETO_FinnGen_FinnGenR5_1	FinnGen	Type 1 diabetes with ketoacidosis / FinnGen
E4_DM1NASCOMP_FinnGen_FinnGenR5_1	FinnGen	Type 1 diabetes with other specified/multiple/u... / FinnGen
E4_DM1NEU_FinnGen_FinnGenR5_1	FinnGen	Type 1 diabetes with neurological complications / FinnGen
E4_DM1NOCOMP_FinnGen_FinnGenR5_1	FinnGen	Type 1 diabetes without complications / FinnGen
E4_DM1OPTH_FinnGen_FinnGenR5_1	FinnGen	Type 1 diabetes with ophthalmic complications / FinnGen
E4_DM1PERIPH_FinnGen_FinnGenR5_1	FinnGen	Type 1 diabetes with peripheral circulatory com... / FinnGen
E4_DM1REN_FinnGen_FinnGenR5_1	FinnGen	Type 1 diabetes with renal complications / FinnGen
E4_DM1_FinnGen_FinnGenR5_1	FinnGen	Type 1 diabetes / FinnGen
E4_DM1_STRICT_FinnGen_FinnGenR5_1	FinnGen	Type 1 diabetes, strict (exclude DM2) / FinnGen
E4_DM2_FinnGen_FinnGenR5_1	FinnGen	Type 2 diabetes / FinnGen
E4_DMNAS_FinnGen_FinnGenR5_1	FinnGen	Unspecified diabetes / FinnGen
E4_ENDOMETPOSTOP_FinnGen_FinnGenR5_1	FinnGen	Postprocedural endocrine and metabolic disorder... / FinnGen
E4_ENDONUTRMET_FinnGen_FinnGenR5_1	FinnGen	Endocrine, nutritional and metabolic diseases / FinnGen
E4_HYTHYNAS_FinnGen_FinnGenR5_1	FinnGen	Hypothyroidism,other/unspecified / FinnGen
E4_HYTHYPOSTINF_FinnGen_FinnGenR5_1	FinnGen	Postinfectious hypothyroidism / FinnGen
E4_HYTHY_AI_STRICT_FinnGen_FinnGenR5_1	FinnGen	Hypothyroidism, strict autoimmune / FinnGen
E4_HYTHY_AI_STRICT_PURCH_FinnGen_FinnGenR5_1	FinnGen	Hypothyroidism, strict autoimmune, 3 medication... / FinnGen
E4_METABO_FinnGen_FinnGenR5_1	FinnGen	Other metabolic disorders / FinnGen
E4_THYROIDITAUTOIM_FinnGen_FinnGenR5_1	FinnGen	Autoimmune thyroiditis / FinnGen
E4_THYROID_FinnGen_FinnGenR5_1	FinnGen	Disorders of the thyroid gland / FinnGen
E4_THYTOXGOITDIF_FinnGen_FinnGenR5_1	FinnGen	Thyrotoxicosis with diffuse goitr / FinnGen
E4_THYTOXNAS_FinnGen_FinnGenR5_1	FinnGen	Thyrotoxicosis, other and/or unspecified / FinnGen
EGPAANCAn_Lyons_31719529_1	Lyons	ANCA negative EGPA (European) / Lyons
EGPAMPO_Lyons_31719529_1	Lyons	MPO+ EGPA (European) / Lyons
EGPA_Lyons_31719529_1	Lyons	EGPA (European) / Lyons
EOE_Chang_34506852_1	Chang	Eosinophilic Esophagitis (European) / Chang
G6_DEMYEL_FinnGen_FinnGenR5_1	FinnGen	Demyelenating diseases of the central nervous s... / FinnGen
G6_DIABETNEUR_FinnGen_FinnGenR5_1	FinnGen	Diabethic neuropathy / FinnGen
G6_MS_FinnGen_FinnGenR5_1	FinnGen	MS-disease / Multiple Sclerosis / FinnGen
GOUT_FinnGen_FinnGenR5_1	FinnGen	Gout / FinnGen
GRAVD_Kubo_BBJ_1	Kubo	Graves' disease (East Asian (Japanese)) / Kubo
GRAVD_Okada_UP_1	Okada	Graves' disease (East Asian (Japanese)) / Okada
H7_ALLERGICCONJUNCTIVITIS_FinnGen_FinnGenR5_1	FinnGen	Allergic conjunctivitis / FinnGen
H7_CHOROIDRETINA_FinnGen_FinnGenR5_1	FinnGen	Disorders of choroid and retina / FinnGen
H7_CONJUNCTIVA_FinnGen_FinnGenR5_1	FinnGen	Disorders of conjunctiva / FinnGen
H7_CONJUNCTIVITIS_FinnGen_FinnGenR5_1	FinnGen	Conjunctivitis / FinnGen
H7_EYE_FinnGen_FinnGenR5_1	FinnGen	Diseases of the eye and adnexa / FinnGen
H7_OPTNEURITIS_FinnGen_FinnGenR5_1	FinnGen	Optic neuritis / FinnGen
H7_RETINALDISOTH_FinnGen_FinnGenR5_1	FinnGen	Other retinal disorders / FinnGen
H7_RETINOPATHYDIAB_BKG_FinnGen_FinnGenR5_1	FinnGen	Diabetic background retinopathy / FinnGen
H7_RETINOPATHYDIAB_BKG_SEVERE_FinnGen_FinnGenR5_1	FinnGen	Severe diabetic background retinopathy / FinnGen
H7_RETINOPATHYDIAB_NAS_FinnGen_FinnGenR5_1	FinnGen	Other diabetic retinopathy / FinnGen
H7_USEOFEYEANTIALLERGENS_FinnGen_FinnGenR5_1	FinnGen	Use of eye-antiallergens (taken as indicator of... / FinnGen
HYPOTHYROIDISM_FinnGen_FinnGenR5_1	FinnGen	Hypothyroidism (congenital or acquired) / FinnGen
HYPOTHY_LEVOTHY_FinnGen_FinnGenR5_1	FinnGen	Hypothyroidism, levothyroxin purchases / FinnGen
HYPOTHY_PURCHASE_FinnGen_FinnGenR5_1	FinnGen	Hypothyroidism and >3 levothyroxin purchases / FinnGen
HYPOTHY_REIMB_FinnGen_FinnGenR5_1	FinnGen	Hypothyroidism, drug reimbursement / FinnGen
IBD_Brant_27693347_1	Brant	Inflammatory Bowel Disease (African (African Am... / Brant
IBD_DeLange_28067908_1	DeLange	Inflammatory Bowel Disease (European) / DeLange
IBD_Liu_26192919_1	Liu	Inflammatory Bowel Disease (European) / Liu
IGAD_Bronson_27723758_1	Bronson	IgA deficiency (European) / Bronson
IIM_Rothwell_up_1	Rothwell	Idiopathic Inflammatory Myopathies (IIM, Myosit... / Rothwell
ILD_ENDPOINTS_FinnGen_FinnGenR5_1	FinnGen	Interstitial lung disease endpoints / FinnGen
J10_ASTHMACOPDKELA_FinnGen_FinnGenR5_1	FinnGen	Asthma/COPD (KELA buy) / FinnGen
J10_ASTHMA_EXMORE_FinnGen_FinnGenR5_1	FinnGen	Asthma (more controls excluded) / FinnGen
J10_ASTHMA_FinnGen_FinnGenR5_1	FinnGen	Asthma / FinnGen
J10_ASTHMA_INCLAVO_FinnGen_FinnGenR5_1	FinnGen	Asthma, including avohilmo / FinnGen
J10_ASTHMA_MAIN_EXMORE_FinnGen_FinnGenR5_1	FinnGen	Asthma, main (more controls excluded) / FinnGen
J10_ASTHMA_MAIN_FinnGen_FinnGenR5_1	FinnGen	Asthma,main / FinnGen
J10_CHRONSINUSITIS_FinnGen_FinnGenR5_1	FinnGen	Chronic sinusitis / FinnGen
J10_COPDNAS_FinnGen_FinnGenR5_1	FinnGen	Other chronic obstructive pulmonary disease / FinnGen
J10_COPD_FinnGen_FinnGenR5_1	FinnGen	COPD / FinnGen
J10_LOWCHRON_FinnGen_FinnGenR5_1	FinnGen	Chronic lower respiratory diseases / FinnGen
J10_NASALPOLYP_FinnGen_FinnGenR5_1	FinnGen	Nasal polyp / FinnGen
J10_RESPIRATORY_FinnGen_FinnGenR5_1	FinnGen	Diseases of the respiratory system / FinnGen
J10_SINUSITIS_FinnGen_FinnGenR5_1	FinnGen	Acute sinusitis / FinnGen
J10_UPPERDIS_FinnGen_FinnGenR5_1	FinnGen	Other diseases of upper respiratory tract / FinnGen
J10_VASOALLERRHIN_FinnGen_FinnGenR5_1	FinnGen	Vasomotor and allergic rhinitis / FinnGen
JDM_Miller_26291516_1	Miller	Juvenile Dermatomyositis (European) / Miller
JDM_Rothwell_up_1	Rothwell	Juvenile Dermatomyositis (European) / Rothwell
JIA_LopezIsac_33106285_1	LopezIsac	Juvenile Idiopathic Arthritis (European (UK)) / LopezIsac
JO1M_Rothwell_up_1	Rothwell	Jo1+ Myositis (European) / Rothwell
JUVEN_ARTHR_FinnGen_FinnGenR5_1	FinnGen	Juvenile arthritis (FINNGEN) / FinnGen
K11_APPENDACUT_FinnGen_FinnGenR5_1	FinnGen	Acute appendicitis / FinnGen
K11_APPENDIX_FinnGen_FinnGenR5_1	FinnGen	Diseases of appendix / FinnGen
K11_CD_NOUC_FinnGen_FinnGenR5_1	FinnGen	Crohn's, strict / FinnGen
K11_CD_STRICT_FinnGen_FinnGenR5_1	FinnGen	Crohn disease (Aki's strict definition, require... / FinnGen
K11_CHOLANGI_STRICT_FinnGen_FinnGenR5_1	FinnGen	Cholangitis (primary sclerosing, PSC), with rei... / FinnGen
K11_COELIAC_FinnGen_FinnGenR5_1	FinnGen	Coeliac disease / FinnGen
K11_CROHN_FinnGen_FinnGenR5_1	FinnGen	Crohn disease / FinnGen
K11_ENERCOLNONINF_FinnGen_FinnGenR5_1	FinnGen	Noninfective enteritis and colitis / FinnGen
K11_GIDISEASES_FinnGen_FinnGenR5_1	FinnGen	Gastrointestinal diseases / FinnGen
K11_IBD_FinnGen_FinnGenR5_1	FinnGen	Inflammatory bowel disease / FinnGen
K11_IBD_STRICT_FinnGen_FinnGenR5_1	FinnGen	Inflammatory bowel disease, strict (require KELA) / FinnGen
K11_IBD_STRICT_PSC_FinnGen_FinnGenR5_1	FinnGen	IBD (strict) with PSC / FinnGen
K11_INTESTOTH_FinnGen_FinnGenR5_1	FinnGen	Other diseases of intestines / FinnGen
K11_KELACROHN_FinnGen_FinnGenR5_1	FinnGen	Crohn's disease patients in KELA-register (KELA... / FinnGen
K11_KELAIBD_FinnGen_FinnGenR5_1	FinnGen	IBD patients in KELA-register / FinnGen
K11_KELAUC_FinnGen_FinnGenR5_1	FinnGen	UC patients in KELA-register ( KELA 208 prior t... / FinnGen
K11_OTHENTERCOL_FinnGen_FinnGenR5_1	FinnGen	Other noninfective gastroenteritis and colitis / FinnGen
K11_PSC_COLITIS_FinnGen_FinnGenR5_1	FinnGen	Colitis, primary sclerosing / FinnGen
K11_PSC_COLITIS_STRICT_FinnGen_FinnGenR5_1	FinnGen	Colitis, primary sclerosing, strict definition / FinnGen
K11_REIMB_202_FinnGen_FinnGenR5_1	FinnGen	KELA_REIMBURSEMENT_202 / FinnGen
K11_UC_NOCD_FinnGen_FinnGenR5_1	FinnGen	Ulcerative colitis (strict definition, all Croh... / FinnGen
K11_UC_STRICT_FinnGen_FinnGenR5_1	FinnGen	Ulcerative colitis (Aki's strict definition, re... / FinnGen
K11_ULCER_FinnGen_FinnGenR5_1	FinnGen	Ulcerative colitis / FinnGen
KELA_DIAB_INSUL_EXMORE_FinnGen_FinnGenR5_1	FinnGen	Diabetes, insuline treatment (Kela reimbursemen... / FinnGen
KELA_DIAB_INSUL_FinnGen_FinnGenR5_1	FinnGen	Diabetes, insuline treatment (Kela reimbursement) / FinnGen
L12_ACTINKERA_FinnGen_FinnGenR5_1	FinnGen	Actinic keratosis / FinnGen
L12_ALLERGICCONTACT_FinnGen_FinnGenR5_1	FinnGen	Alergic contact dermatitis / FinnGen
L12_ATOPIC_FinnGen_FinnGenR5_1	FinnGen	Atopic dermatitis / FinnGen
L12_DERMATITISECZEMA_FinnGen_FinnGenR5_1	FinnGen	Dermatitis and eczema / FinnGen
L12_DERMATITISNAS_FinnGen_FinnGenR5_1	FinnGen	Other and unspecified dermatitis / FinnGen
L12_LICHENPLANUS_FinnGen_FinnGenR5_1	FinnGen	Lichen planus / FinnGen
L12_LICHENSCLERATROPH_FinnGen_FinnGenR5_1	FinnGen	Lichen sclerosus et atrophicus / FinnGen
L12_LICHSIMPANDPRURIGO_FinnGen_FinnGenR5_1	FinnGen	Lichen simplex chronicus and prurigo / FinnGen
L12_LUPUS_FinnGen_FinnGenR5_1	FinnGen	Lupus erythematosus / FinnGen
L12_NONIONRADISKIN_FinnGen_FinnGenR5_1	FinnGen	Skin changes due to chronic exposure to nonioni... / FinnGen
L12_PAPULOSQUAMOUS_FinnGen_FinnGenR5_1	FinnGen	Papulosquamous disorders / FinnGen
L12_PSORI_PUSTUPALM_FinnGen_FinnGenR5_1	FinnGen	Pustulosis palmaris et plantaris / FinnGen
L12_RADIATIONRELATEDSKIN_FinnGen_FinnGenR5_1	FinnGen	Radiation-related disorders of the skin and sub... / FinnGen
L12_SKIN_FinnGen_FinnGenR5_1	FinnGen	Diseases of the skin and subcutaneous tissue / FinnGen
M13_ANKYLOSPON_FinnGen_FinnGenR5_1	FinnGen	Ankylosing spondylitis / FinnGen
M13_ANKYLOSPON_STRICT_FinnGen_FinnGenR5_1	FinnGen	Ankylosing spondylitis, strict definition / FinnGen
M13_ARTHRITISNAS_FinnGen_FinnGenR5_1	FinnGen	Ohter specific/unspecified arthritis / FinnGen
M13_ARTHROPATHIES_FinnGen_FinnGenR5_1	FinnGen	Arthropathies / FinnGen
M13_CONNECTNAS_FinnGen_FinnGenR5_1	FinnGen	Other specified/unspecified systemic involvemen... / FinnGen
M13_DERMATOPOLY_FinnGen_FinnGenR5_1	FinnGen	Dermatopolymyositis / FinnGen
M13_ENTEROARTHR_FinnGen_FinnGenR5_1	FinnGen	Enteropathic arthropathies / FinnGen
M13_JUVEARTH_FinnGen_FinnGenR5_1	FinnGen	Other juvenile arthritis / FinnGen
M13_JUVERHEU_FinnGen_FinnGenR5_1	FinnGen	Juvenile rheuma / FinnGen
M13_OTHCONN_FinnGen_FinnGenR5_1	FinnGen	Other systemic involvement of connective tissue / FinnGen
M13_OVERLAP_FinnGen_FinnGenR5_1	FinnGen	Other overlap syndromes / FinnGen
M13_PALINDROMIC_FinnGen_FinnGenR5_1	FinnGen	Palindromic rheumatism / FinnGen
M13_POLYARTHROPATHIES_FinnGen_FinnGenR5_1	FinnGen	Polyarthropathies / FinnGen
M13_POLYMYALGIA_FinnGen_FinnGenR5_1	FinnGen	Polymyalgia rheumatica / FinnGen
M13_POLYMYO_FinnGen_FinnGenR5_1	FinnGen	Polymyositis / FinnGen
M13_RHEUMA_FinnGen_FinnGenR5_1	FinnGen	Rheumatoid arthritis / FinnGen
M13_RHEUMA_INCLAVO_FinnGen_FinnGenR5_1	FinnGen	Rheumatoid arthritis, including avohilmo / FinnGen
M13_SJOGREN_FinnGen_FinnGenR5_1	FinnGen	Sicca syndrome [Sjogren] / FinnGen
M13_SLE_FinnGen_FinnGenR5_1	FinnGen	Systemic lupus erythematosus / FinnGen
M13_SYSTCONNECT_FinnGen_FinnGenR5_1	FinnGen	Systemic connective tissue disorders / FinnGen
M13_SYSTSLCE_FinnGen_FinnGenR5_1	FinnGen	Systemic sclerosis / FinnGen
MS_IMSGC_31604244_1	IMSGC	Multiple Sclerosis (European (Multiple countries)) / IMSGC
MUCOPROCT_FinnGen_FinnGenR5_1	FinnGen	Mucosal proctocolitis / FinnGen
MYGEO_Renton_25643325_1	Renton	Early-onset Myastenia Gravis (European (North A... / Renton
MYGLO_Renton_25643325_1	Renton	Late-onset Myastenia Gravis (European (North Am... / Renton
MYG_Renton_25643325_1	Renton	Myastenia Gravis (European (North America)) / Renton
MYO_Miller_26291516_1	Miller	Myositis (European) / Miller
NONALLERG_ASTHMA_EXMORE_FinnGen_FinnGenR5_1	FinnGen	Non-allergic asthma (mode) (more controls exclu... / FinnGen
NONALLERG_ASTHMA_FinnGen_FinnGenR5_1	FinnGen	Non-allergic asthma / FinnGen
OPER_TOTAL_COLECTOMY_FinnGen_FinnGenR5_1	FinnGen	Total colectomy operation / FinnGen
PM_Miller_26291516_1	Miller	Polymyositis (European) / Miller
PM_Rothwell_up_1	Rothwell	Polymyositis (European) / Rothwell
POLLENALLERG_FinnGen_FinnGenR5_1	FinnGen	Pollen allergy / FinnGen
PSOR_ENTE_ARTHR_FinnGen_FinnGenR5_1	FinnGen	Psoriatic and enteropathic arthropathies / FinnGen
PULM_INFECTIONS_FinnGen_FinnGenR5_1	FinnGen	COPD/asthma/ILD related infections / FinnGen
RA_Okada_24390342_2	Okada	Rheumatoid Arthritis (Asian) / Okada
RA_Okada_24390342_3	Okada	Rheumatoid Arthritis (Trans-ethnic (European + ... / Okada
RHEC_Ferreira_29083406_1	Ferreira	Rhinitis-only vs. eczema-only (European) / Ferreira
RHEUMA_ENDPOINTS_FinnGen_FinnGenR5_1	FinnGen	Finngen Rheumatological endpoints / FinnGen
RHEUMA_NOS_FinnGen_FinnGenR5_1	FinnGen	Other/unspecified rheumatoid arthritis / FinnGen
RHEUMA_OTHER_WIDE_FinnGen_FinnGenR5_1	FinnGen	Other (seronegative) rheumatoid arthritis, wide / FinnGen
RHEUMA_SERONEG_FinnGen_FinnGenR5_1	FinnGen	Seronegative rheumatoid arthritis / FinnGen
RHEUMA_SEROPOS_FinnGen_FinnGenR5_1	FinnGen	Seropositive rheumatoid arthritis / FinnGen
RHEUMA_SEROPOS_OTH_FinnGen_FinnGenR5_1	FinnGen	Other/unspecified seropositiverheumatoid arthritis / FinnGen
RHEUMA_SEROPOS_STRICT_FinnGen_FinnGenR5_1	FinnGen	Seropositive rheumatoid arthritis, strict defin... / FinnGen
RHEUMA_SEROPOS_WIDE_FinnGen_FinnGenR5_1	FinnGen	Seropositive rheumatoid arthritis, wide / FinnGen
RHEU_ARTHRITIS_OTH_FinnGen_FinnGenR5_1	FinnGen	Other arthritis / FinnGen
RX_CROHN_1STLINE_FinnGen_FinnGenR5_1	FinnGen	First line medication for Crohns disease / FinnGen
RX_CROHN_2NDLINE_FinnGen_FinnGenR5_1	FinnGen	Second line medication for Crohns disease / FinnGen
RX_RHEUMA_BIOLOGICAL_FinnGen_FinnGenR5_1	FinnGen	Biological medication for rheuma / FinnGen
SLE_FG_FinnGen_FinnGenR5_1	FinnGen	SLE / FinnGen
SLE_Julia_29848360_1	Julia	Systemic Lupus Erythematosus (European (North +... / Julia
SLE_Julia_29848360_2	Julia	Systemic Lupus Erythematosus (European (Spanish)) / Julia
SLE_NOS_FinnGen_FinnGenR5_1	FinnGen	Systemic lupus erythematosus, unspecified / FinnGen
SLE_OTH_FinnGen_FinnGenR5_1	FinnGen	Other forms of systemic lupus erythematosus / FinnGen
SLE_STRICT_FinnGen_FinnGenR5_1	FinnGen	SLE, strict definition / FinnGen
SPONDYLOARTHRITIS_FinnGen_FinnGenR5_1	FinnGen	Spondyloarthritis / FinnGen
SPONDYLOPATHY_FG_FinnGen_FinnGenR5_1	FinnGen	Spondylopathies / FinnGen
SSC_LopezIsac_31672989_1	LopezIsac	Systemic Sclerosis (European) / LopezIsac
ST19_ADVER_EFFEC_NOT_ELSEW_CLASSIFIED_FinnGen_FinnGenR5_1	FinnGen	Adverse effects, not elsewhere classified / FinnGen
STILL_ADULT_FinnGen_FinnGenR5_1	FinnGen	Adult-onset Still disease / FinnGen
T1D_Chiou_34012112_1	Chiou	Type 1 Diabetes (European) / Chiou
T1D_FinnGen_FinnGenR5_1	FinnGen	Type 1 Diabetes / FinnGen
T1D_Inshaw_up_1	Inshaw	Type 1 Diabetes (European) / Inshaw
T1D_STRICT1_FinnGen_FinnGenR5_1	FinnGen	Type 1 diabetes, strict definition, subgroup 1 / FinnGen
T1D_STRICT_FinnGen_FinnGenR5_1	FinnGen	Type 1 diabetes, strict defin1tion / FinnGen
T1D_WIDE1_FinnGen_FinnGenR5_1	FinnGen	Type 1 diabetes, wide definition, subgroup 1 / FinnGen
T1D_WIDE_FinnGen_FinnGenR5_1	FinnGen	Type 1 diabetes, wide definition / FinnGen
T2D_Mahajan_30297969_1	Mahajan	Type 2 Diabetes (European) / Mahajan
T2D_Xue_30054458_1	Xue	Type 2 Diabetes (European) / Xue
THYROIDITIS_FinnGen_FinnGenR5_1	FinnGen	Thyroiditis / FinnGen
THYROID_DISORDER_IBD_FinnGen_FinnGenR5_1	FinnGen	Disorders of thyroid, IBD co-morbidities / FinnGen
THYROTOXICOSIS_FinnGen_FinnGenR5_1	FinnGen	Thyrotoxicosis / FinnGen
UC_Anderson_21297633_1	Anderson	Ulcerative Colitis (European) / Anderson
UC_Brant_27693347_1	Brant	Ulcerative Colitis (African (African Americans)) / Brant
UC_Liu_26192919_1	Liu	Ulcerative Colitis (European) / Liu
ULCERENTER_FinnGen_FinnGenR5_1	FinnGen	Ulcerative enterocolitis / FinnGen
ULCERILEO_FinnGen_FinnGenR5_1	FinnGen	Ulcerative ileocolitis / FinnGen
ULCERNAS_FinnGen_FinnGenR5_1	FinnGen	Ulcerative colitis, NAS / FinnGen
ULCEROTH_FinnGen_FinnGenR5_1	FinnGen	Other ulcerative colitis / FinnGen
ULCERPROCT_FinnGen_FinnGenR5_1	FinnGen	Ulcerative proctitis / FinnGen
ULCERRECT_FinnGen_FinnGenR5_1	FinnGen	Ulcerative rectosigmoiditis / FinnGen
ULCER_ARTHR_FinnGen_FinnGenR5_1	FinnGen	Arthropathy in ulcerative colitis / FinnGen
Z21_OTHER_SPECIAL_EXAM_INVES_PERSONS_WO_COMPLA_REPOR_DIAGNOSIS_FinnGen_FinnGenR5_1	FinnGen	Other special examinations and investigations o... / FinnGen
Z21_PERSONS_ENCOUNTERI_HEALTH_SERVI_EXAM_INVES_FinnGen_FinnGenR5_1	FinnGen	Persons encountering health services for examin... / FinnGen
ph172.2_PanUKBB_PanUKBBR1_1	PanUKBB	Other non-epithelial cancer of skin (European (... / UKBB
ph172_PanUKBB_PanUKBBR1_1	PanUKBB	Skin cancer (European (EUR)) / UKBB
ph242_PanUKBB_PanUKBBR1_1	PanUKBB	Thyrotoxicosis with or without goiter (Trans-et... / UKBB
ph244.1_PanUKBB_PanUKBBR1_1	PanUKBB	Secondary hypothyroidism (European (EUR)) / UKBB
ph244.4_PanUKBB_PanUKBBR1_1	PanUKBB	Hypothyroidism NOS (Trans-ethnic (AFR,CSA,EAS,E... / UKBB
ph244_PanUKBB_PanUKBBR1_1	PanUKBB	Hypothyroidism (Trans-ethnic (AFR,CSA,EAS,EUR)) / UKBB
ph245.21_PanUKBB_PanUKBBR1_1	PanUKBB	Chronic lymphocytic thyroiditis (European (EUR)) / UKBB
ph245.2_PanUKBB_PanUKBBR1_1	PanUKBB	Chronic thyroiditis (European (EUR)) / UKBB
ph245_PanUKBB_PanUKBBR1_1	PanUKBB	Thyroiditis (European (EUR)) / UKBB
ph250.11_PanUKBB_PanUKBBR1_1	PanUKBB	Type 1 diabetes with ketoacidosis (European (EUR)) / UKBB
ph250.13_PanUKBB_PanUKBBR1_1	PanUKBB	Type 1 diabetes with ophthalmic manifestations ... / UKBB
ph250.1_PanUKBB_PanUKBBR1_1	PanUKBB	Type 1 diabetes (Trans-ethnic (AFR,CSA,EUR)) / UKBB
ph250.7_PanUKBB_PanUKBBR1_1	PanUKBB	Diabetic retinopathy (Trans-ethnic (AFR,CSA,EUR)) / UKBB
ph250_PanUKBB_PanUKBBR1_1	PanUKBB	Diabetes mellitus (Trans-ethnic (AFR,CSA,EAS,EU... / UKBB
ph280.1_PanUKBB_PanUKBBR1_1	PanUKBB	Iron deficiency anemias, unspecified or not due... / UKBB
ph280_PanUKBB_PanUKBBR1_1	PanUKBB	Iron deficiency anemias (Trans-ethnic (AFR,CSA,... / UKBB
ph281.11_PanUKBB_PanUKBBR1_1	PanUKBB	Pernicious anemia (European (EUR)) / UKBB
ph281.12_PanUKBB_PanUKBBR1_1	PanUKBB	Other vitamin B12 deficiency anemia (European (... / UKBB
ph281.1_PanUKBB_PanUKBBR1_1	PanUKBB	Megaloblastic anemia (Trans-ethnic (CSA,EUR)) / UKBB
ph281_PanUKBB_PanUKBBR1_1	PanUKBB	Other deficiency anemia (Trans-ethnic (CSA,EUR)) / UKBB
ph285_PanUKBB_PanUKBBR1_1	PanUKBB	Other anemias (Trans-ethnic (AFR,CSA,EAS,EUR,MID)) / UKBB
ph335_PanUKBB_PanUKBBR1_1	PanUKBB	Multiple sclerosis (European (EUR)) / UKBB
ph362.7_PanUKBB_PanUKBBR1_1	PanUKBB	Hereditary retinal dystrophies (Trans-ethnic (A... / UKBB
ph371.3_PanUKBB_PanUKBBR1_1	PanUKBB	Inflammation of eyelids (Trans-ethnic (CSA,EUR)) / UKBB
ph371_PanUKBB_PanUKBBR1_1	PanUKBB	Inflammation of the eye (Trans-ethnic (AFR,CSA,... / UKBB
ph401.1_PanUKBB_PanUKBBR1_1	PanUKBB	Essential hypertension (Trans-ethnic (AFR,AMR,C... / UKBB
ph401_PanUKBB_PanUKBBR1_1	PanUKBB	Hypertension (Trans-ethnic (AFR,AMR,CSA,EAS,EUR... / UKBB
ph471_PanUKBB_PanUKBBR1_1	PanUKBB	Nasal polyps (Trans-ethnic (CSA,EUR)) / UKBB
ph475_PanUKBB_PanUKBBR1_1	PanUKBB	Chronic sinusitis (Trans-ethnic (CSA,EUR)) / UKBB
ph476_PanUKBB_PanUKBBR1_1	PanUKBB	Allergic rhinitis (European (EUR)) / UKBB
ph479_PanUKBB_PanUKBBR1_1	PanUKBB	Other upper respiratory disease (Trans-ethnic (... / UKBB
ph495.2_PanUKBB_PanUKBBR1_1	PanUKBB	Asthma with exacerbation (European (EUR)) / UKBB
ph495_PanUKBB_PanUKBBR1_1	PanUKBB	Asthma (Trans-ethnic (AFR,AMR,CSA,EAS,EUR,MID)) / UKBB
ph496.21_PanUKBB_PanUKBBR1_1	PanUKBB	Obstructive chronic bronchitis (Trans-ethnic (A... / UKBB
ph496.2_PanUKBB_PanUKBBR1_1	PanUKBB	Chronic bronchitis (Trans-ethnic (AFR,CSA,EUR)) / UKBB
ph496.3_PanUKBB_PanUKBBR1_1	PanUKBB	Bronchiectasis (European (EUR)) / UKBB
ph496_PanUKBB_PanUKBBR1_1	PanUKBB	Chronic airway obstruction (Trans-ethnic (AFR,E... / UKBB
ph519_PanUKBB_PanUKBBR1_1	PanUKBB	Other diseases of respiratory system, not elsew... / UKBB
ph535_PanUKBB_PanUKBBR1_1	PanUKBB	Gastritis and duodenitis (Trans-ethnic (AFR,AMR... / UKBB
ph555.1_PanUKBB_PanUKBBR1_1	PanUKBB	Regional enteritis (European (EUR)) / UKBB
ph555.21_PanUKBB_PanUKBBR1_1	PanUKBB	Ulcerative colitis (chronic) (European (EUR)) / UKBB
ph555.2_PanUKBB_PanUKBBR1_1	PanUKBB	Ulcerative colitis (European (EUR)) / UKBB
ph555_PanUKBB_PanUKBBR1_1	PanUKBB	Inflammatory bowel disease and other gastroente... / UKBB
ph556.1_PanUKBB_PanUKBBR1_1	PanUKBB	Ulceration of intestine (European (EUR)) / UKBB
ph556_PanUKBB_PanUKBBR1_1	PanUKBB	Ulceration of the lower GI tract (European (EUR)) / UKBB
ph557.1_PanUKBB_PanUKBBR1_1	PanUKBB	Celiac disease (European (EUR)) / UKBB
ph557_PanUKBB_PanUKBBR1_1	PanUKBB	Intestinal malabsorption (non-celiac) (European... / UKBB
ph558_PanUKBB_PanUKBBR1_1	PanUKBB	Noninfectious gastroenteritis (Trans-ethnic (AF... / UKBB
ph559_PanUKBB_PanUKBBR1_1	PanUKBB	Ileostomy status (European (EUR)) / UKBB
ph560.4_PanUKBB_PanUKBBR1_1	PanUKBB	Other intestinal obstruction (European (EUR)) / UKBB
ph561_PanUKBB_PanUKBBR1_1	PanUKBB	Symptoms involving digestive system (Trans-ethn... / UKBB
ph571.6_PanUKBB_PanUKBBR1_1	PanUKBB	Primary biliary cirrhosis (European (EUR)) / UKBB
ph574.1_PanUKBB_PanUKBBR1_1	PanUKBB	Cholelithiasis (Trans-ethnic (AFR,CSA,EAS,EUR)) / UKBB
ph578_PanUKBB_PanUKBBR1_1	PanUKBB	Gastrointestinal hemorrhage (Trans-ethnic (AFR,... / UKBB
ph695.41_PanUKBB_PanUKBBR1_1	PanUKBB	Cutaneous lupus erythematosus (European (EUR)) / UKBB
ph695.42_PanUKBB_PanUKBBR1_1	PanUKBB	Systemic lupus erythematosus (European (EUR)) / UKBB
ph695.4_PanUKBB_PanUKBBR1_1	PanUKBB	Lupus (localized and systemic) (European (EUR)) / UKBB
ph697_PanUKBB_PanUKBBR1_1	PanUKBB	Sarcoidosis (Trans-ethnic (AFR,EUR)) / UKBB
ph702.1_PanUKBB_PanUKBBR1_1	PanUKBB	Actinic keratosis (European (EUR)) / UKBB
ph702.2_PanUKBB_PanUKBBR1_1	PanUKBB	Seborrheic keratosis (European (EUR)) / UKBB
ph702_PanUKBB_PanUKBBR1_1	PanUKBB	Degenerative skin conditions and other dermatos... / UKBB
ph709.2_PanUKBB_PanUKBBR1_1	PanUKBB	Sicca syndrome (European (EUR)) / UKBB
ph709.3_PanUKBB_PanUKBBR1_1	PanUKBB	Systemic sclerosis (European (EUR)) / UKBB
ph709_PanUKBB_PanUKBBR1_1	PanUKBB	Diffuse diseases of connective tissue (European... / UKBB
ph714.1_PanUKBB_PanUKBBR1_1	PanUKBB	Rheumatoid arthritis (Trans-ethnic (AFR,CSA,EUR)) / UKBB
ph714_PanUKBB_PanUKBBR1_1	PanUKBB	Rheumatoid arthritis and other inflammatory pol... / UKBB
ph715.2_PanUKBB_PanUKBBR1_1	PanUKBB	Ankylosing spondylitis (European (EUR)) / UKBB
ph853_PanUKBB_PanUKBBR1_1	PanUKBB	Complication of colostomy or enterostomy (Europ... / UKBB
ph938.2_PanUKBB_PanUKBBR1_1	PanUKBB	Chronic dermatitis due to solar radiation (Euro... / UKBB
ph938_PanUKBB_PanUKBBR1_1	PanUKBB	Dermatitis due to solar radiation (European (EUR)) / UKBB
ph939_PanUKBB_PanUKBBR1_1	PanUKBB	Atopic/contact dermatitis due to other or unspe... / UKBB
ph960.2_PanUKBB_PanUKBBR1_1	PanUKBB	Allergy/adverse effect of penicillin (Trans-eth... / UKBB
ph960_PanUKBB_PanUKBBR1_1	PanUKBB	Poisoning by antibiotics (Trans-ethnic (AFR,CSA... / UKBB
ph961_PanUKBB_PanUKBBR1_1	PanUKBB	Poisoning by other anti-infectives (European (E... / UKBB
